MECCANICA	ING_BRUNO	TXT	E' la barra antirollio...
VECCHI	ING_BRUNO	MP3	vecchio.mp3
VECCHIO	ING_BRUNO	MP3	vecchio.mp3
VECCHIA	ING_BRUNO	MP3	vecchio.mp3
MANSEL	ING_BRUNO	MP3	mansell.mp3

SIBILLINO	BORTUZZO	MP3	sibillino1.mp3
SIBILLINO	BORTUZZO	MP3	sibillino2.mp3
SIBILLINOH	BORTUZZO	MP3	sibillino1.mp3
SIBILLINOH	BORTUZZO	MP3	sibillino2.mp3
SIBILLINO	BORTUZZO	MP3	sibillino3.mp3
SIBILLINOH	BORTUZZO	MP3	sibillino3.mp3
CAPITO	BORTUZZO	MP3	capito.mp3

COMPETITIV	IVAN	MP3	competitivi.mp3

CIAO	MAZZONI	MP3	saluto.mp3
DUCT	MAZZONI	MP3	duck.mp3
CICLISMO	MAZZONI	MP3	ciclismo.mp3
BICI	MAZZONI	MP3	ciclismo.mp3
HORNER	MAZZONI	MP3	horner.mp3
COLLEGAMENTO	MAZZONI	MP3	apertura.mp3
DISCORSO	MAZZONI	MP3	discorso.mp3
POLEMIC	MAZZONI	MP3	polemiche.mp3
LAUREA	MAZZONI	MP3	ingegneria.mp3
INGEGNERIA	MAZZONI	MP3	ingegneria.mp3
FRENATA	MAZZONI	MP3	frenata.mp3
STACCATA	MAZZONI	MP3	frenata.mp3
DAVANTI	MAZZONI	MP3	davanti.mp3
SEXY	MAZZONI	IMG	maldonado.jpg
IMPAZZITO	MAZZONI	MP3	aperturadistorto.mp3

TOTO	TOTO	MP3	federicatoto.mp3
FEDERICA	TOTO	MP3	federicatoto.mp3
WOLF	TOTO	MP3	federicatoto.mp3
MASOLIN	TOTO	MP3	federicatoto.mp3

FUCK	VETTEL	TXT	Honestly!!
HONESTLY	VETTEL	TXT	Fuck off Charlie!!

KIMI	RAIKKONEN	TXT	Bwoah... 
DOVE ERI	RAIKKONEN	TXT	I was having a shit...!!
DOVE SEI	RAIKKONEN	TXT	I was having a shit...!!
DOVE ERA	RAIKKONEN	TXT	I was having a shit...!!

DOMANDA	ROSBERG	MP3	domanda.mp3
SONDAGGIO	ROSBERG	MP3	domanda.mp3

HUMOR	ALONSO	MP3	humor.mp3
ENGINE	ALONSO	MP3	gp2engine.mp3 
GENI	ALONSO	MP3	gp2engine.mp3
SCEMI	ALONSO	STICKER	BQADBAADAQIAAo-zWQOR2wt7uXUfPAI
SEXY	ALONSO	STICKER	BQADAQADIgADuVOBDK1OuDEmY2GOAg
